40 40 0 560
0	0	0	0	0	0	459	460	0	0	0	0	0	0	0	0	0	0	0	0	0	0	0	0	0	0	0	0	0	0	0	0	0	0	0	0	0	0	434	435
0	0	0	0	0	0	434	435	0	0	0	0	0	0	0	0	0	0	0	0	0	0	0	0	0	0	0	0	0	0	0	0	0	0	0	0	0	0	459	460
0	0	0	0	0	0	459	460	0	0	0	0	0	0	0	0	0	0	0	0	0	0	0	0	0	0	0	0	0	0	0	0	0	0	0	0	0	0	434	435
0	0	0	0	0	0	434	435	0	0	0	0	0	0	0	0	0	0	0	0	0	0	0	0	0	0	0	0	0	0	0	0	0	0	0	431	432	433	459	460
0	0	0	0	0	0	459	460	0	0	0	0	0	0	0	0	0	0	0	0	0	0	0	0	211	211	0	0	0	236	0	0	0	0	0	0	0	0	434	435
0	0	0	0	0	0	434	435	0	0	0	0	0	0	0	0	0	0	0	211	211	0	0	0	236	236	236	236	236	236	0	0	0	0	0	0	0	0	459	460
0	0	0	0	0	0	459	460	0	0	0	0	0	0	0	0	236	236	236	236	236	0	0	0	0	0	0	0	0	0	0	0	0	0	0	0	0	0	459	460
0	0	0	0	0	0	434	435	0	0	0	0	0	0	0	0	0	0	0	0	0	0	0	0	0	0	0	0	0	0	0	0	0	0	0	0	0	0	434	435
0	0	0	0	0	0	459	460	0	0	0	0	0	0	0	0	0	0	0	0	0	0	0	0	0	0	0	0	0	0	0	0	0	0	0	0	0	0	459	460
0	0	0	0	0	0	434	435	436	437	438	0	0	0	0	0	0	0	0	0	0	0	0	0	0	0	0	0	0	0	0	0	0	0	0	0	0	0	434	435
0	0	0	0	0	0	459	460	0	0	0	0	0	0	0	0	0	0	0	0	0	0	0	0	0	0	0	0	0	0	0	0	0	0	0	0	0	0	459	460
0	0	0	0	0	0	434	435	0	0	0	0	0	0	0	0	0	0	0	0	0	0	0	0	0	0	0	0	0	0	2	4	0	0	0	0	0	0	434	435
0	0	0	0	0	0	459	460	0	0	0	0	0	0	2	4	0	0	0	0	0	0	2	4	0	0	0	0	0	0	102	104	0	0	0	0	0	0	459	460
0	0	0	0	0	0	434	435	0	0	0	0	0	0	102	104	0	0	0	0	0	0	102	104	0	0	0	0	0	0	0	0	0	0	0	0	0	2	3	3
0	0	0	0	0	0	459	460	0	0	0	0	0	0	0	0	0	0	0	0	0	0	0	0	0	0	0	0	0	0	0	0	0	0	0	0	0	102	103	103
0	0	0	0	0	0	434	435	0	0	0	0	0	0	0	0	0	0	0	0	0	0	0	0	0	0	0	0	0	0	0	0	0	0	0	0	0	0	0	0
0	0	0	0	0	0	459	460	0	0	0	0	0	0	0	0	0	0	0	0	0	0	0	0	0	0	0	0	0	0	0	0	0	0	0	0	0	0	0	0
0	0	0	0	0	0	434	435	0	0	0	0	0	0	0	0	0	0	0	0	0	0	0	0	0	0	0	0	0	0	0	0	0	2	3	3	4	0	0	0
0	0	0	0	0	0	459	460	0	0	0	0	0	0	0	0	0	0	0	0	0	0	0	16	17	0	0	0	0	0	0	0	0	102	103	103	104	0	0	0
0	0	0	0	0	0	434	435	0	0	0	0	0	0	0	0	64	65	0	0	0	0	0	41	42	0	0	0	0	0	0	0	0	0	0	0	0	0	0	0
0	0	0	0	0	0	459	460	0	0	0	0	0	0	0	2	3	3	3	3	3	3	3	3	4	0	0	0	0	0	0	0	0	0	0	0	0	0	0	0
0	0	0	431	432	433	434	435	0	0	0	0	0	0	0	51	52	28	28	28	28	28	28	54	55	0	0	0	0	0	0	0	0	0	0	0	0	0	0	0
0	0	0	0	0	0	459	460	0	0	0	0	0	0	0	51	52	28	28	28	28	28	61	54	55	0	0	0	0	0	0	0	0	0	0	0	0	0	0	0
0	0	0	0	0	0	434	435	436	437	438	0	0	0	0	76	77	78	78	78	78	78	78	79	80	0	0	0	0	0	0	0	0	0	0	0	0	0	0	0
0	0	0	0	0	0	459	460	0	0	0	0	0	0	0	0	102	103	103	103	103	103	103	104	0	0	0	0	0	0	0	0	0	0	0	0	0	0	0	0
0	0	0	0	0	0	434	435	0	0	0	0	0	0	0	0	0	0	0	0	0	0	0	0	0	0	0	0	0	0	0	0	0	0	0	0	0	0	0	0
0	0	0	0	0	0	459	460	0	0	0	0	0	0	0	0	0	0	0	0	0	0	0	0	0	0	0	0	0	0	0	0	0	0	0	0	0	0	0	0
0	0	0	0	0	0	434	435	436	437	437	437	437	438	0	0	0	0	0	2	4	0	0	0	2	4	0	0	0	0	0	0	0	0	0	0	0	0	0	0
0	0	0	0	0	0	459	460	0	0	0	0	0	0	0	0	0	0	0	102	104	0	0	0	102	104	0	0	0	0	0	0	0	38	39	40	0	0	0	0
0	0	0	0	431	433	434	435	0	0	0	0	0	0	0	0	0	0	0	0	0	0	0	0	0	0	0	0	0	0	0	0	2	3	3	4	0	0	0	0
0	0	0	0	0	0	459	460	0	0	0	0	0	0	0	0	0	0	0	0	0	0	0	0	0	0	0	0	0	0	0	0	102	103	103	104	0	0	0	0
0	0	0	0	0	0	434	435	0	0	0	0	0	0	0	0	0	0	0	0	0	0	0	0	0	0	0	0	0	0	0	0	0	0	0	0	0	0	0	0
0	0	0	0	0	0	459	460	0	0	0	0	0	0	0	0	0	0	0	0	0	0	0	0	0	0	0	0	0	0	0	0	0	0	0	0	0	0	0	0
0	0	0	0	0	0	434	435	0	0	0	0	0	0	0	0	0	0	0	0	0	14	0	0	0	0	0	0	0	0	0	0	0	0	0	0	0	0	2	3
0	0	0	0	0	0	459	460	0	0	0	0	0	0	0	0	0	0	0	2	3	4	0	0	0	0	0	0	0	0	0	0	0	0	0	0	0	0	51	28
0	0	0	0	0	0	434	435	0	0	0	0	0	0	13	0	0	0	0	102	103	104	0	0	0	0	0	0	0	0	0	0	0	0	0	0	0	0	51	28
0	13	0	0	63	0	459	460	38	39	40	0	0	0	2	3	4	0	0	0	0	0	0	0	0	0	0	0	0	0	0	0	0	0	0	0	0	0	51	28
3	3	3	3	3	3	3	3	3	3	30	0	0	0	102	103	104	0	0	0	0	0	0	0	0	0	0	0	0	0	0	0	0	0	0	0	0	2	27	28
28	28	28	28	28	28	28	28	61	28	55	0	0	0	0	0	0	0	0	0	0	0	0	0	131	132	132	132	132	133	0	0	0	0	0	0	0	51	28	61
28	28	28	28	61	28	28	28	28	28	55	59	60	59	60	59	60	59	60	59	60	59	60	59	60	59	60	59	60	59	60	59	60	59	60	59	60	51	28	28