64	80	64	1146																																																												
0	0	0	0	0	434	435	0	0	0	0	0	0	0	0	0	0	0	0	0	0	0	0	0	0	0	0	0	0	0	0	0	0	0	459	460	0	0	0	0	0	0	0	0	0	0	0	0	0	0	0	0	0	0	0	0	0	0	0	0	0	0	0	0
0	0	0	0	0	459	460	0	0	0	0	0	0	0	0	0	0	0	0	0	0	0	0	0	0	0	0	0	0	0	0	0	0	0	434	435	0	0	0	0	0	0	0	0	0	0	0	0	0	0	0	0	0	0	0	0	0	0	0	0	0	0	0	0
0	0	0	0	0	434	435	0	0	0	0	0	0	0	0	0	0	0	0	0	0	0	0	0	0	0	0	0	0	0	0	0	0	0	459	460	0	0	0	0	0	0	0	0	0	0	0	0	0	0	0	0	0	0	0	0	0	0	0	0	0	0	0	0
0	0	0	0	0	459	460	0	0	0	0	0	0	0	0	0	0	0	0	0	0	0	0	0	0	0	0	0	0	0	0	0	0	0	434	435	0	0	0	0	0	0	0	0	0	0	0	0	0	0	0	0	0	0	0	0	0	0	0	0	0	0	0	0
0	0	0	0	0	434	435	0	0	0	0	0	0	0	0	0	0	0	0	0	0	0	0	0	0	0	0	0	0	0	0	0	0	0	459	460	0	0	0	0	0	0	0	0	0	0	0	0	0	0	0	0	0	0	0	0	0	0	0	0	0	0	0	0
0	0	0	0	0	459	460	0	0	0	0	0	0	0	0	0	0	0	0	0	0	0	0	0	0	0	0	0	0	0	0	0	0	0	434	435	0	0	0	0	0	0	0	0	0	0	0	0	0	0	0	0	0	0	0	0	0	0	0	0	0	0	0	0
0	0	0	0	0	434	435	0	0	0	0	0	0	0	0	0	0	0	0	0	0	0	0	0	0	0	0	0	0	0	0	0	0	0	459	460	0	0	0	0	0	0	0	0	0	0	0	0	0	0	0	0	0	0	0	0	0	0	0	0	0	0	0	0
0	0	0	0	0	459	460	0	0	0	0	0	0	0	0	0	0	0	0	0	0	0	0	0	0	0	0	0	0	0	0	0	0	0	434	435	0	0	0	0	0	0	0	0	0	0	0	0	0	0	0	0	0	0	0	0	0	0	0	0	0	0	0	0
0	0	0	0	0	434	435	0	0	0	0	0	0	0	0	0	0	0	0	0	0	0	0	0	0	0	0	0	0	0	0	0	0	0	459	460	0	0	0	0	0	0	0	0	0	0	0	0	0	0	0	0	0	0	0	0	0	0	0	0	0	0	0	0
0	0	0	0	0	459	460	0	0	0	0	0	0	0	0	0	0	0	0	0	0	0	0	0	0	0	0	0	0	0	0	0	0	0	434	435	0	0	0	0	0	0	0	0	0	0	0	0	0	0	0	0	0	0	0	0	0	0	0	0	0	0	0	0
0	0	0	0	0	434	435	0	0	0	0	0	0	0	0	0	0	0	0	0	0	0	0	0	0	0	0	0	0	0	0	0	0	0	459	460	0	0	0	0	0	0	0	0	0	0	0	0	0	0	0	0	0	0	0	0	0	0	0	0	0	0	0	0
0	0	0	0	0	459	460	0	0	0	0	0	0	0	0	0	0	0	0	0	0	0	0	0	0	0	0	0	0	0	0	0	0	0	434	435	0	0	0	0	0	0	0	0	0	0	0	0	0	0	0	0	0	0	0	0	0	0	0	0	0	0	0	0
0	0	0	0	0	434	435	0	0	0	0	0	0	0	0	0	0	0	0	0	0	0	0	0	0	0	0	0	0	0	0	0	0	0	459	460	0	0	0	0	0	0	0	0	0	0	0	0	0	0	0	0	0	0	0	0	0	0	0	0	0	0	0	0
0	0	0	0	0	459	460	0	0	0	0	0	0	0	0	0	0	0	0	0	0	0	0	0	0	0	0	0	0	0	0	0	0	0	434	435	0	0	0	0	0	0	0	0	0	0	0	0	0	0	0	0	0	0	0	0	0	0	0	0	0	0	0	0
0	0	0	0	0	434	435	0	0	0	0	0	0	0	0	0	0	0	0	0	0	0	0	0	0	0	0	0	0	0	0	0	0	0	459	460	0	0	0	0	0	0	0	0	0	0	0	0	0	0	0	0	0	0	0	0	0	0	0	0	0	0	0	0
0	0	0	0	0	459	460	0	0	0	0	0	0	0	0	0	0	0	0	0	0	0	0	0	0	0	0	0	0	0	0	0	0	0	434	435	0	0	0	0	0	0	0	0	0	0	0	0	0	0	0	0	0	0	0	0	0	0	0	0	0	0	0	0
0	0	0	0	0	434	435	0	0	0	0	0	0	0	0	0	0	0	0	0	0	0	0	0	0	0	0	0	0	0	0	0	0	0	459	460	0	0	0	0	0	0	0	0	0	0	0	0	0	0	0	0	0	0	0	0	0	0	0	0	0	0	0	0
0	0	0	0	0	459	460	0	0	0	0	0	0	0	0	0	0	0	0	0	0	0	0	0	0	0	0	0	0	0	0	0	0	0	434	435	0	0	0	0	0	0	0	0	0	0	0	0	0	0	0	0	0	0	0	0	0	0	0	0	0	0	0	0
0	0	0	0	0	434	435	0	0	0	0	0	0	0	0	0	0	0	0	0	0	0	0	0	0	0	0	0	0	0	0	0	0	0	459	460	0	0	0	0	0	0	0	0	0	0	0	0	0	0	0	0	0	0	0	0	0	0	0	0	0	0	0	0
0	0	0	0	0	459	460	0	0	0	0	0	0	0	0	0	0	0	0	0	0	0	0	0	0	0	0	0	0	0	0	0	0	0	434	435	0	0	0	0	0	0	0	0	0	0	0	0	0	0	0	0	0	0	0	0	0	0	0	0	0	0	0	0
0	0	0	0	0	434	435	0	0	0	0	0	0	0	0	0	0	0	0	0	0	0	0	0	0	0	0	0	0	0	0	0	0	0	459	460	0	0	0	0	0	0	0	0	0	0	0	0	0	0	0	0	0	0	0	0	0	0	0	0	0	0	0	0
0	0	0	0	0	459	460	0	0	0	0	0	0	0	0	0	0	0	0	0	0	0	0	0	0	0	0	0	0	0	0	0	0	0	434	435	0	0	0	0	0	0	0	0	0	0	0	0	0	0	0	0	0	0	0	0	0	0	0	0	0	0	0	0
0	0	0	0	0	434	435	0	0	0	0	0	0	0	0	0	0	0	0	0	0	0	0	0	0	0	0	0	0	0	0	0	0	0	459	460	0	0	0	0	0	0	0	0	0	0	0	0	0	0	0	0	0	0	0	0	0	0	0	0	0	0	0	0
0	0	0	0	0	459	460	0	0	0	0	0	0	0	0	0	0	0	0	0	0	0	0	0	0	0	0	0	0	0	0	0	0	0	434	435	0	0	0	0	0	0	0	0	0	0	0	0	0	0	0	0	0	0	0	0	0	0	0	0	0	0	0	0
0	0	0	0	0	434	435	0	0	0	0	0	0	0	0	0	0	0	0	0	0	0	0	0	0	0	0	0	0	0	0	0	0	0	459	460	0	0	0	0	0	0	0	0	0	0	0	0	0	0	0	0	0	0	0	0	0	0	0	0	0	0	0	0
0	0	0	0	0	459	460	0	0	0	0	0	0	0	0	0	0	0	0	0	0	0	0	0	0	0	0	0	0	0	0	0	0	0	434	435	0	0	0	0	0	0	0	0	0	0	0	0	0	0	0	0	0	0	0	0	0	0	0	0	0	0	0	0
0	0	0	0	0	434	435	0	0	0	0	0	0	0	0	0	0	0	0	0	0	0	0	0	0	0	0	0	0	0	0	0	0	0	459	460	0	0	0	0	0	0	0	0	0	0	0	0	0	0	0	0	0	0	0	0	0	0	0	0	0	0	0	0
0	0	0	0	0	459	460	0	0	0	0	0	0	0	0	0	0	0	0	0	0	0	0	0	0	0	0	0	0	0	0	0	0	0	434	435	0	0	0	0	0	0	0	0	0	0	0	0	0	0	0	0	0	0	0	0	0	0	0	0	0	0	0	0
0	0	0	0	0	434	435	0	0	0	0	0	0	0	0	0	0	0	0	0	0	0	0	0	0	0	0	0	0	0	0	0	0	0	459	460	0	0	0	0	0	0	0	0	0	0	0	0	0	0	0	0	0	0	0	0	0	0	0	0	0	0	0	0
0	0	0	0	0	459	460	0	0	0	0	0	0	0	0	0	0	0	0	0	0	0	0	0	0	0	0	0	0	0	0	0	0	0	434	435	0	0	0	0	0	0	0	0	0	0	0	0	0	0	0	0	0	0	0	0	0	0	0	0	0	0	0	0
0	0	0	0	0	434	435	0	0	0	0	0	0	0	0	0	0	0	0	0	0	0	0	0	0	0	0	0	0	0	0	0	0	0	459	460	0	0	0	0	0	0	0	0	0	0	0	0	0	0	0	0	0	0	0	0	0	0	0	0	0	0	0	0
0	0	0	0	0	459	460	0	0	0	0	0	0	0	0	0	0	0	0	0	0	0	0	0	0	0	0	0	0	0	0	0	0	0	434	435	0	0	0	0	0	0	0	0	0	0	0	0	0	0	0	0	0	0	0	0	0	0	0	0	0	0	0	0
0	0	0	0	0	434	435	0	0	0	0	0	0	0	0	0	0	0	0	0	0	0	14	14	0	0	0	0	0	0	0	0	0	0	459	460	0	0	0	0	0	0	0	0	0	0	0	0	0	0	0	0	0	0	0	0	0	0	0	0	0	0	0	0
0	0	0	0	0	459	460	0	0	0	0	0	0	0	0	0	0	0	0	0	0	0	2	4	0	0	0	0	0	0	0	0	0	0	434	435	0	0	0	0	0	0	0	0	0	0	0	0	0	0	0	0	0	0	0	0	0	0	0	0	0	0	0	0
0	0	0	0	0	434	435	0	0	0	0	0	0	0	0	0	0	0	0	0	0	0	102	104	0	0	0	0	0	0	0	0	0	0	459	460	0	0	0	0	0	0	0	0	0	0	0	0	0	0	0	0	0	0	0	0	0	0	0	0	0	0	0	0
0	0	0	0	0	459	460	0	0	0	0	0	0	0	0	0	0	0	0	0	0	0	0	0	0	0	0	0	0	0	0	0	0	0	434	435	0	0	0	0	0	0	0	0	0	0	0	0	0	0	0	0	0	0	0	0	0	0	0	0	0	0	0	0
0	0	0	0	0	434	435	0	0	0	0	0	0	0	0	0	0	0	0	0	0	0	0	0	0	0	0	13	0	0	0	0	0	0	459	460	0	0	0	0	0	0	0	0	0	0	0	0	0	0	0	0	0	0	0	0	0	0	0	0	0	0	0	0
0	0	0	0	0	459	460	0	0	0	0	0	0	0	0	0	0	0	0	0	0	0	0	0	0	0	2	4	0	0	0	0	0	0	434	435	0	0	0	0	0	0	0	0	0	0	0	0	0	0	0	0	0	0	0	0	0	0	0	0	0	0	0	0
0	0	0	0	0	434	435	0	0	0	0	0	0	0	0	0	0	0	0	0	0	0	0	0	0	0	102	104	0	0	0	0	0	0	459	460	0	0	0	0	0	0	0	0	0	0	0	0	0	0	0	0	0	0	0	0	0	0	0	0	0	0	0	0
0	0	0	0	0	459	460	0	0	0	0	0	0	0	0	0	0	0	0	0	0	0	0	0	0	0	0	0	0	0	0	0	0	0	434	435	0	0	0	0	0	0	0	0	0	0	0	0	0	0	0	0	0	0	0	0	0	0	0	0	0	0	0	0
0	0	0	0	0	434	435	0	0	0	0	0	0	0	0	0	0	0	377	379	0	0	0	0	0	0	0	0	0	0	0	0	0	0	459	460	0	0	0	0	0	0	0	0	0	0	0	0	0	0	0	0	0	0	0	0	0	0	0	0	0	0	0	2
0	0	0	0	0	459	460	0	0	0	0	0	0	0	0	0	0	401	402	404	405	0	0	0	0	0	0	0	0	0	431	432	432	433	434	435	0	0	0	0	0	0	0	0	0	0	0	0	15	0	0	0	0	0	0	0	0	0	0	0	0	0	0	51
0	0	0	0	0	434	435	0	0	0	377	379	0	0	0	0	0	426	427	428	430	0	0	0	0	0	0	0	0	0	0	0	0	0	459	460	0	0	0	0	0	0	0	0	0	0	0	2	4	0	38	39	40	0	0	0	15	0	0	0	0	0	0	51
0	0	0	0	0	459	460	0	0	401	402	404	405	0	0	0	0	451	452	454	455	0	0	0	0	0	0	0	0	0	0	0	0	0	434	435	0	0	0	0	0	0	0	0	0	0	0	51	29	3	3	3	3	3	3	3	3	255	253	254	93	0	0	51
0	0	0	0	0	434	435	0	0	426	427	428	430	0	0	0	0	0	477	479	0	0	0	0	0	0	0	0	0	0	0	0	0	0	459	460	436	437	437	438	0	0	0	0	0	0	0	51	79	103	103	103	103	103	103	103	103	103	103	279	253	254	0	51
0	0	0	0	0	459	460	0	0	451	452	454	455	0	0	0	0	0	459	460	0	0	0	0	0	0	0	0	0	0	0	0	0	0	434	435	0	0	0	0	0	0	0	0	0	0	0	51	55	0	0	0	0	114	0	0	0	0	0	102	103	104	0	51
0	0	0	0	0	434	435	0	0	0	477	479	0	0	0	0	0	0	434	435	0	0	0	0	0	0	0	0	0	0	0	0	0	0	459	460	0	0	0	0	0	0	0	0	0	0	0	51	55	0	0	0	0	139	0	0	0	0	0	0	0	0	0	51
0	0	0	0	0	459	460	0	0	0	459	460	0	0	0	0	0	0	459	460	0	0	0	0	0	0	0	0	0	0	0	0	0	0	434	435	0	0	0	0	0	0	0	0	0	0	0	51	55	0	0	0	93	164	0	0	0	0	0	0	0	0	0	51
0	0	0	0	0	434	435	0	0	0	434	435	0	0	0	0	0	0	434	435	0	0	0	0	0	0	0	0	0	0	0	0	0	0	459	460	0	0	0	0	0	0	0	0	0	0	0	51	55	0	0	0	252	254	211	211	211	252	254	211	211	211	252	277
0	0	0	0	0	459	460	0	0	0	459	460	0	0	0	0	0	0	459	460	0	0	0	0	0	0	0	0	0	0	0	0	0	0	434	435	436	437	438	0	0	0	0	0	0	0	0	51	55	0	0	252	277	279	253	253	253	277	279	253	253	253	277	28
0	0	0	0	0	434	435	0	0	0	434	435	0	0	0	0	0	0	434	435	436	437	438	0	0	0	0	0	0	0	0	0	0	0	459	460	0	0	0	0	0	0	0	0	0	0	0	51	55	0	0	102	103	103	103	103	103	103	103	103	103	77	28	28
0	0	0	0	0	459	460	0	0	0	459	460	0	0	0	0	0	0	459	460	0	0	0	0	0	0	0	0	0	0	0	0	0	0	434	435	0	0	0	0	0	0	0	0	0	0	0	51	55	0	0	0	0	0	0	114	0	0	0	114	0	51	28	28
0	0	0	0	0	434	435	0	0	0	434	435	0	0	0	0	0	0	434	435	0	0	0	0	0	0	0	0	0	0	0	0	0	0	459	460	0	0	0	0	0	0	0	0	0	0	0	51	55	0	0	0	0	0	0	139	0	0	0	139	0	51	28	28
0	0	0	0	0	459	460	0	0	0	459	460	0	0	0	0	0	0	459	460	0	0	0	0	0	0	0	0	0	0	0	0	0	0	434	435	0	0	0	0	0	0	0	0	0	0	0	51	279	254	0	67	0	0	0	139	0	0	0	139	0	51	28	28
0	0	0	0	0	434	435	0	0	0	434	435	0	0	0	0	0	0	434	435	0	0	0	0	0	0	0	0	0	0	0	431	432	433	459	460	0	0	0	0	0	0	0	0	0	0	0	51	28	279	253	253	253	254	68	139	0	0	0	139	0	51	28	28
0	0	0	0	0	459	460	0	0	0	459	460	0	0	0	0	0	0	459	460	0	0	0	0	0	0	0	0	0	0	0	0	0	0	434	435	0	0	0	0	0	0	0	0	0	0	0	102	103	103	103	103	103	279	253	254	0	0	0	139	0	51	28	28
0	0	0	0	0	434	435	436	438	0	434	435	0	0	0	0	0	0	434	435	0	0	0	0	0	0	0	0	0	0	0	0	0	0	459	460	0	0	0	0	0	0	0	0	0	0	0	0	0	114	0	0	0	102	103	80	0	0	0	139	0	51	28	28
0	0	0	0	0	459	460	0	0	0	459	460	0	0	0	0	0	0	459	460	0	0	0	0	0	0	0	0	0	0	0	0	0	0	434	435	0	0	0	0	0	0	0	0	0	0	0	0	0	139	0	0	0	0	0	139	0	0	0	164	93	51	28	28
0	0	0	0	0	434	435	0	0	0	434	435	0	0	0	0	0	0	434	435	0	0	0	0	0	0	0	0	0	0	0	0	0	0	459	460	0	0	0	0	0	0	0	0	0	0	0	0	0	139	0	0	0	0	0	139	0	0	0	252	253	277	28	28
0	0	0	0	0	459	460	0	0	0	459	460	0	0	0	0	0	0	459	460	0	0	0	0	0	0	0	0	0	0	0	0	0	0	434	435	0	0	0	0	0	0	0	0	0	0	0	0	0	164	0	0	0	0	0	139	0	0	0	51	28	28	28	28
0	0	0	0	0	434	435	0	0	0	434	435	0	0	0	0	0	0	434	435	0	0	0	0	0	0	0	0	0	0	0	0	0	0	459	460	0	0	0	0	0	0	0	0	0	0	2	3	255	253	254	0	93	0	0	139	0	0	0	51	28	53	28	28
0	0	0	0	0	459	460	0	0	0	459	460	0	0	0	0	0	0	459	460	0	0	0	0	0	0	0	0	0	0	0	0	0	0	434	435	0	0	0	0	0	0	0	0	0	0	51	28	28	28	279	253	254	0	0	164	0	0	0	51	28	28	28	28
0	0	431	432	433	434	435	0	0	0	434	435	0	0	0	0	0	0	434	435	0	0	0	0	0	0	0	0	0	0	0	0	0	0	459	460	436	437	437	437	438	0	0	0	0	0	51	28	28	28	28	28	279	253	253	253	254	211	211	51	28	28	28	28
0	0	0	0	0	459	460	0	0	0	459	460	0	0	0	0	0	0	459	460	0	0	0	0	0	0	0	0	0	0	0	0	0	0	434	435	0	0	0	0	0	0	0	0	0	0	51	28	28	53	53	28	28	28	28	28	279	253	253	277	28	28	61	28
0	0	0	0	0	434	435	0	0	0	434	435	0	0	0	0	0	0	434	435	0	0	0	0	0	0	0	0	0	0	0	0	0	0	459	460	0	0	0	0	0	0	0	0	0	0	51	28	28	28	28	28	28	28	28	28	28	28	28	28	28	28	28	28
0	0	0	0	0	459	460	0	0	0	459	460	0	0	0	0	0	0	459	460	0	0	0	0	0	0	0	0	0	0	0	0	0	0	434	435	0	0	0	0	0	0	0	0	0	0	51	28	28	28	28	28	53	28	28	28	28	61	28	28	28	28	28	28
0	0	0	0	0	434	435	0	0	0	434	435	0	0	0	0	0	0	434	435	0	0	0	0	0	0	0	0	0	0	431	432	432	433	459	460	0	0	0	0	0	0	0	0	0	0	51	28	61	28	28	28	53	28	28	28	28	28	28	28	28	28	28	28
0	0	0	0	0	459	460	0	0	0	459	460	0	0	0	0	0	0	459	460	0	0	0	0	0	0	0	0	0	0	0	0	0	0	434	435	0	0	0	0	0	0	0	0	0	0	51	28	28	28	28	28	28	28	28	53	28	28	28	28	28	53	53	28
0	0	0	0	0	434	435	0	0	0	434	435	0	0	0	0	0	0	434	435	0	0	0	0	0	0	0	0	0	0	0	0	0	0	459	460	0	0	0	0	0	0	0	0	0	0	51	28	28	28	28	53	28	28	28	28	28	28	28	28	28	28	28	28
0	0	0	0	0	459	460	0	0	0	459	460	0	0	0	0	0	0	459	460	0	0	0	0	0	0	0	0	0	0	0	0	0	0	434	435	436	437	437	438	0	0	0	0	0	0	51	28	28	28	28	28	28	28	28	28	28	28	61	28	28	28	28	28
0	0	0	0	0	434	435	0	0	0	434	435	0	0	0	0	0	0	434	435	0	0	0	0	0	0	0	0	0	0	0	0	0	0	459	460	0	0	0	0	0	0	0	0	0	2	27	28	53	28	28	28	28	28	28	28	28	28	28	28	28	28	28	28
0	0	0	0	0	459	460	0	0	0	459	460	0	0	0	0	14	0	459	460	0	15	0	0	0	0	0	0	0	0	0	0	0	0	434	435	0	0	0	0	0	0	0	0	0	51	28	28	28	28	28	28	28	28	28	28	53	28	28	28	28	28	61	28
0	0	0	16	17	434	435	0	0	0	434	435	0	0	0	2	3	3	3	3	3	4	0	0	0	0	0	0	0	0	0	0	0	0	459	460	0	0	0	0	0	0	0	0	0	51	28	28	28	28	28	28	28	61	28	28	28	28	28	28	28	28	28	28
0	0	0	41	42	459	460	0	0	63	459	460	0	0	0	51	28	28	61	28	53	55	0	0	0	13	0	0	0	0	0	0	0	0	434	435	0	0	0	0	0	0	0	15	0	51	28	28	28	61	28	28	28	28	28	28	28	28	28	28	28	28	28	28
0	0	0	2	3	3	3	3	3	3	3	3	4	0	0	51	28	28	28	28	28	55	0	0	2	4	0	0	0	0	0	0	0	0	459	460	0	0	0	0	0	0	0	2	3	27	28	28	28	28	28	28	28	28	28	28	28	28	28	53	28	28	28	28
0	0	0	51	28	28	28	28	28	28	28	28	55	0	0	51	53	28	28	28	61	55	0	0	102	104	0	0	0	0	0	0	0	0	434	435	0	0	0	0	0	0	0	51	28	28	28	28	28	28	28	28	28	28	28	28	28	28	28	28	28	28	28	53
0	0	0	51	52	53	54	54	54	54	54	61	55	0	0	76	77	28	28	28	79	80	0	0	0	0	0	0	0	0	0	0	13	0	459	460	0	15	0	0	0	0	0	51	54	61	28	28	28	28	28	61	28	28	28	61	28	28	28	28	28	28	28	28
0	0	0	51	52	52	52	52	53	54	54	54	55	0	0	0	51	28	53	28	55	0	0	0	0	0	0	14	0	14	0	2	3	3	3	3	3	4	0	0	0	0	0	76	77	28	28	28	53	28	28	28	28	28	28	28	28	28	28	28	28	28	28	28
0	0	0	51	52	61	52	52	52	52	53	54	29	30	0	0	51	61	28	28	55	0	0	0	0	0	0	2	3	3	3	27	28	54	28	28	28	55	0	0	0	0	0	0	51	28	28	61	28	28	28	28	28	28	28	53	28	28	28	61	28	28	28	28
0	0	0	51	28	28	28	28	28	61	28	28	28	55	0	0	51	53	28	28	55	0	0	0	0	0	0	51	28	28	28	28	53	61	28	28	54	29	30	0	0	0	0	0	76	77	28	28	28	28	28	28	28	28	28	28	28	28	28	28	28	28	28	28
0	0	0	0	0	0	0	0	0	0	0	0	0	0	0	0	0	0	0	0	0	0	0	0	0	0	0	0	0	0	0	0	0	0	0	0	0	0	0	0	0	0	0	0	0	0	0	0	0	0	0	0	0	0	0	0	0	0	0	0	0	0	0	0
0	0	0	0	0	0	0	0	0	0	0	0	0	0	0	0	0	0	0	0	0	0	0	0	0	0	0	0	0	0	0	0	0	0	0	0	0	0	0	0	0	0	0	0	0	0	0	0	0	0	0	0	0	0	0	0	0	0	0	0	0	0	0	0
0	0	0	0	0	0	0	0	0	0	0	0	0	0	0	0	0	0	0	0	0	0	0	0	0	0	0	0	0	0	0	0	0	0	0	0	0	0	0	0	0	0	0	0	0	0	0	0	0	0	0	0	0	0	0	0	0	0	0	0	0	0	0	0
0	0	0	0	0	0	0	0	0	0	0	0	0	0	0	0	0	0	0	0	0	0	0	0	0	0	0	0	0	0	0	0	0	0	0	0	0	0	0	0	0	0	0	0	0	0	0	0	0	0	0	0	0	0	0	0	0	0	0	0	0	0	0	0
0	0	0	0	0	0	0	0	0	0	0	0	0	0	0	0	0	0	0	0	0	0	0	0	0	0	0	0	0	0	0	0	0	0	0	0	0	0	0	0	0	0	0	0	0	0	0	0	0	0	0	0	0	0	0	0	0	0	0	0	0	0	0	0
0	0	0	0	0	0	0	0	0	0	0	0	0	0	0	0	0	0	0	0	0	0	0	0	0	0	0	0	0	0	0	0	0	0	0	0	0	0	0	0	0	0	0	0	0	0	0	0	0	0	0	0	0	0	0	0	0	0	0	0	0	0	0	0
0	0	0	0	0	0	0	0	0	0	0	0	0	0	0	0	0	0	0	0	0	0	0	0	0	0	0	0	0	0	0	0	0	0	0	0	0	0	0	0	0	0	0	0	0	0	0	0	0	0	0	0	0	0	0	0	0	0	0	0	0	0	0	0
0	0	0	0	0	0	0	0	0	0	0	0	0	0	0	0	0	0	0	0	0	0	0	0	0	0	0	0	0	0	0	0	0	0	0	0	0	0	0	0	0	0	0	0	0	0	0	0	0	0	0	0	0	0	0	0	0	0	0	0	0	0	0	0
0	0	0	0	0	0	0	0	0	0	0	0	0	0	0	0	0	0	0	0	0	0	0	0	0	0	0	0	0	0	0	0	0	0	0	0	0	0	0	0	0	0	0	0	0	0	0	0	0	0	0	0	0	0	0	0	0	0	0	0	0	0	0	0
0	0	0	0	0	0	0	0	0	0	0	0	0	0	0	0	0	0	0	0	0	0	0	0	0	0	0	0	0	0	0	0	0	0	0	0	0	0	0	0	0	0	0	0	0	0	0	0	0	0	0	0	0	0	0	0	0	0	0	0	0	0	0	0
0	0	0	0	0	0	0	0	0	0	0	0	0	0	0	0	0	0	0	0	0	0	0	0	0	0	0	0	0	0	0	0	0	0	0	0	0	0	0	0	0	0	0	0	0	0	0	0	0	0	0	0	0	0	0	0	0	0	0	0	0	0	0	0
0	0	0	0	0	0	0	0	0	0	0	0	0	0	0	0	0	0	0	0	0	0	0	0	0	0	0	0	0	0	0	0	0	0	0	0	0	0	0	0	0	0	0	0	0	0	0	0	0	0	0	0	0	0	0	0	0	0	0	0	0	0	0	0
0	0	0	0	0	0	0	0	0	0	0	0	0	0	0	0	0	0	0	0	0	0	0	0	0	0	0	0	0	0	0	0	0	0	0	0	0	0	0	0	0	0	0	0	0	0	0	0	0	0	0	0	0	0	0	0	0	0	0	0	0	0	0	0
0	0	0	0	0	0	0	0	0	0	0	0	0	0	0	0	0	0	0	0	0	0	0	0	0	0	0	0	0	0	0	0	0	0	0	0	0	0	0	0	0	0	0	0	0	0	0	0	0	0	0	0	0	0	0	0	0	0	0	0	0	0	0	0
0	0	0	0	0	0	0	0	0	0	0	0	0	0	0	0	0	0	0	0	0	0	0	0	0	0	0	0	0	0	0	0	0	0	0	0	0	0	0	0	0	0	0	0	0	0	0	0	0	0	0	0	0	0	0	0	0	0	0	0	0	0	0	0
0	0	0	0	0	0	0	504	482	0	0	0	0	0	0	0	0	0	0	0	0	0	0	0	0	0	0	0	0	0	0	0	0	0	0	0	0	0	0	0	0	0	0	0	0	0	0	0	0	0	0	0	0	0	0	0	0	0	0	0	0	0	0	0
0	0	0	0	0	0	0	529	533	0	0	0	0	0	0	0	0	0	0	0	0	0	0	0	0	0	0	0	0	0	0	0	0	0	0	0	0	0	0	0	0	0	0	0	0	0	0	0	0	0	0	0	0	0	0	0	0	0	0	0	0	0	0	0
0	0	0	0	0	0	0	554	582	0	0	0	0	0	0	0	0	0	0	0	0	0	0	0	0	0	0	0	0	0	0	0	0	0	0	0	0	0	0	0	0	0	0	0	0	0	0	0	0	0	0	0	0	0	0	0	0	0	0	0	0	0	0	0
0	0	0	0	0	0	0	0	0	0	0	0	0	0	0	0	0	0	0	0	0	0	0	0	0	0	0	0	0	0	0	0	0	0	0	0	0	0	0	0	0	0	0	0	0	0	0	0	0	0	0	0	0	0	0	0	0	0	0	0	0	0	0	0
0	0	0	0	0	0	0	0	0	0	0	0	0	0	0	0	0	0	0	0	0	0	0	0	0	0	0	0	0	0	0	0	0	0	0	0	0	0	0	0	0	0	0	0	0	0	0	0	0	0	0	0	0	0	0	0	0	0	0	0	0	0	0	0
0	0	0	0	0	0	0	0	0	0	0	0	0	0	0	0	0	0	0	0	0	0	0	0	0	0	0	0	0	0	0	0	0	0	0	0	0	0	0	0	0	0	0	0	0	0	0	0	0	0	0	0	0	0	0	0	0	0	0	0	0	0	0	0
0	0	0	0	0	0	0	0	0	0	0	0	0	0	0	0	0	0	0	0	0	0	0	0	0	0	0	0	0	0	0	0	0	0	0	0	0	0	0	0	0	0	0	0	0	0	0	0	0	0	0	0	0	0	0	0	0	0	0	0	0	0	0	0
0	0	0	0	0	0	0	0	0	0	0	0	0	0	0	0	0	0	0	0	0	0	0	0	0	0	0	0	0	0	0	0	0	0	0	0	0	0	0	0	0	0	0	0	0	0	0	0	0	0	0	0	0	0	0	0	0	0	0	0	0	0	0	0
0	0	0	0	0	0	0	0	0	0	0	0	0	0	0	0	0	0	0	0	0	0	0	0	0	0	0	0	0	0	0	0	0	0	0	0	0	0	0	0	0	0	0	0	0	0	0	0	0	0	0	0	0	0	0	0	0	0	0	0	0	0	0	0
0	0	0	0	0	0	0	0	0	0	0	0	0	0	0	0	0	0	0	0	0	0	0	0	0	0	0	0	0	0	0	0	0	0	0	0	0	0	0	0	0	0	0	0	0	0	0	0	0	0	0	0	0	0	0	0	0	0	0	0	0	0	0	0
0	0	0	0	0	0	0	0	0	0	0	0	0	0	0	0	0	0	0	0	0	0	0	0	0	0	0	0	0	0	0	0	0	0	0	0	0	0	0	0	0	0	0	0	0	0	0	0	0	0	0	0	0	0	0	0	0	0	0	0	0	0	0	0
0	0	0	0	504	482	0	0	0	0	0	0	0	0	0	0	0	0	0	0	0	0	0	0	0	0	0	0	0	0	0	0	0	0	0	0	0	0	0	0	0	0	0	0	0	0	0	0	0	0	0	0	0	0	0	0	0	0	0	0	0	0	0	0
0	0	0	0	529	582	0	0	0	0	0	0	0	0	0	0	0	0	0	0	0	0	0	0	0	0	0	0	0	0	0	0	0	0	0	0	0	0	0	0	0	0	0	0	0	0	0	0	0	0	0	0	0	0	0	0	0	0	0	0	0	0	0	0
0	0	0	0	554	0	0	0	0	0	0	0	0	0	0	0	0	0	0	0	0	0	0	0	0	0	0	0	0	0	0	0	0	0	0	0	0	0	0	0	0	0	0	0	0	0	0	0	0	0	0	0	0	0	0	0	0	0	0	0	0	0	0	0
0	0	0	0	0	0	0	0	0	0	0	0	0	0	0	0	0	0	0	0	0	0	0	0	0	0	0	0	0	0	0	0	0	0	0	0	0	0	0	0	0	0	0	0	0	0	0	0	0	0	0	0	0	0	0	0	0	0	0	0	0	0	0	0
0	0	0	0	0	0	0	0	0	0	0	0	0	0	0	0	0	0	0	0	0	0	0	0	0	0	0	0	0	0	0	0	0	0	0	0	0	0	0	0	0	0	0	0	0	0	0	0	0	0	0	0	0	0	0	0	0	0	0	0	0	0	0	0
0	0	0	0	0	0	0	0	0	0	0	0	0	0	0	0	0	0	0	0	0	0	0	0	0	0	0	0	0	0	0	0	0	0	0	0	0	0	0	0	0	0	0	0	0	0	0	0	0	0	0	0	0	0	0	0	0	0	0	0	0	0	0	0
0	0	0	0	0	0	0	0	0	0	0	0	0	0	0	0	0	0	0	0	0	0	0	0	0	0	0	0	0	0	0	0	0	0	0	0	0	0	0	0	0	0	0	0	0	0	0	0	0	0	0	0	0	0	0	0	0	0	0	0	0	0	0	0
0	0	0	0	0	0	0	0	0	0	0	0	0	0	0	0	0	0	0	0	0	0	0	0	0	0	0	0	0	0	0	0	0	0	0	0	0	0	0	0	0	0	0	0	0	0	0	0	0	0	0	0	0	0	0	0	0	0	0	0	0	0	0	0
0	0	0	0	0	0	480	482	0	0	0	0	0	0	0	0	0	0	0	0	0	0	0	0	0	0	0	0	0	0	0	0	0	0	0	0	0	0	0	0	0	0	0	0	0	0	0	0	0	0	0	0	0	0	0	0	0	0	0	0	0	0	0	0
0	0	0	0	0	0	580	533	0	0	0	0	0	0	0	0	0	0	0	0	0	0	0	0	0	0	0	0	0	0	0	0	0	0	0	0	0	0	0	0	0	0	0	0	0	0	0	0	0	0	0	0	0	0	0	0	0	0	0	0	0	0	0	0
0	0	0	0	0	0	0	582	0	0	0	0	0	0	0	0	0	0	0	0	0	0	0	0	0	0	0	0	0	0	0	0	0	0	0	0	0	0	0	0	0	0	0	0	0	0	0	0	0	0	0	0	0	0	0	0	0	0	0	0	0	0	0	0
0	0	0	0	0	0	0	0	0	0	0	0	0	0	0	0	0	0	0	0	0	0	0	0	0	0	0	0	0	0	0	0	0	0	0	0	0	0	0	0	0	0	0	0	0	0	0	0	0	0	0	0	0	0	0	0	0	0	0	0	0	0	0	0
0	0	0	0	0	0	0	0	0	0	0	0	0	0	0	0	0	0	0	0	0	0	0	0	0	0	0	0	0	0	0	0	0	0	0	0	0	0	0	0	0	0	0	0	0	0	0	0	0	0	0	0	0	0	0	0	0	0	0	0	0	0	0	0
0	0	0	0	0	0	0	0	0	0	0	0	0	0	0	0	0	0	0	0	0	0	0	0	0	0	0	0	0	0	0	0	0	0	0	0	0	0	0	0	0	0	0	0	0	0	0	0	0	0	0	0	0	0	0	0	0	0	0	0	0	0	0	0
0	0	0	0	504	482	0	0	0	0	0	0	0	0	0	0	0	0	0	0	0	0	0	0	0	0	0	0	0	0	0	0	0	0	0	0	0	0	0	0	0	0	0	0	0	0	0	0	0	0	0	0	0	0	0	0	0	0	0	0	0	0	0	0
0	0	0	0	529	582	0	0	0	0	0	0	0	0	0	0	0	0	0	0	0	0	0	0	0	0	0	0	0	0	0	0	0	0	0	0	0	0	0	0	0	0	0	0	0	0	0	0	0	0	0	0	0	0	0	0	0	0	0	0	0	0	0	0
0	0	0	0	554	0	0	0	0	0	0	0	0	0	0	0	0	0	0	0	0	0	0	0	0	0	0	0	0	0	0	0	0	0	0	0	482	0	0	0	0	0	0	0	0	0	0	0	0	0	0	0	0	0	0	0	0	0	0	0	0	0	0	0
0	0	0	0	0	0	0	0	0	0	0	0	0	0	0	0	0	0	459	460	0	0	0	0	0	0	0	0	0	0	0	0	0	0	0	0	533	0	0	0	0	0	0	0	0	0	0	0	178	178	178	178	178	178	178	178	178	178	178	178	0	0	0	0
0	0	0	0	0	0	0	0	0	0	434	435	0	0	0	0	0	0	434	435	0	0	0	0	0	0	0	0	0	0	0	0	0	0	0	0	582	0	0	0	0	0	0	0	0	0	0	0	178	178	178	178	178	178	178	178	178	178	178	178	0	0	0	0
0	0	0	0	0	0	0	0	0	0	459	460	0	0	0	0	0	0	459	460	0	0	0	0	0	0	0	0	0	0	0	0	0	0	0	0	0	0	0	0	0	0	0	0	0	0	0	0	178	178	178	178	178	178	178	178	178	178	178	178	178	180	0	0
0	0	0	0	0	0	480	482	0	0	434	435	0	0	0	0	0	0	434	435	0	0	0	0	0	0	0	0	0	0	0	0	0	0	0	0	0	0	0	0	0	0	0	0	0	0	0	0	178	178	178	178	178	178	178	178	178	178	178	178	178	180	0	0
0	0	0	0	0	0	580	582	0	0	459	460	0	0	0	0	0	0	459	460	0	0	0	0	0	0	0	0	0	0	0	0	0	0	0	0	0	0	0	0	0	0	0	0	0	0	0	0	178	236	178	178	178	178	178	178	178	178	178	178	178	180	0	0
0	0	0	0	0	0	0	0	0	0	434	435	0	0	0	0	0	0	434	435	0	0	0	0	0	0	0	0	0	0	0	0	0	0	0	0	0	0	0	0	0	0	0	0	0	0	0	0	178	178	178	178	178	178	178	178	178	178	178	178	178	180	178	178
0	0	0	0	0	0	0	0	0	480	459	460	0	0	0	0	0	504	482	460	0	0	0	0	0	0	0	0	0	0	0	0	0	0	0	0	0	0	0	0	0	0	0	0	0	0	0	0	178	178	178	178	178	236	178	178	178	178	178	178	178	178	178	178
0	0	0	0	0	0	0	0	0	580	434	435	0	0	0	0	0	529	582	435	0	0	0	0	0	0	0	0	0	0	0	0	0	0	0	0	0	0	0	0	0	0	0	0	0	0	0	0	178	178	178	178	178	178	178	178	178	178	178	178	178	178	178	178
0	0	0	0	0	0	0	0	0	0	459	460	0	0	0	0	0	554	459	460	0	0	0	0	0	0	0	0	0	0	0	0	0	0	504	0	0	0	0	0	0	0	0	0	0	0	0	0	178	178	178	178	178	178	178	178	178	178	178	178	178	178	178	178
0	0	0	0	504	482	0	0	0	0	434	435	0	0	0	0	0	0	434	435	0	0	0	0	0	0	0	0	0	0	0	0	0	0	529	0	0	0	0	0	0	0	0	0	0	0	0	0	178	178	178	178	178	178	178	178	178	178	178	178	178	178	178	178
0	0	0	0	529	582	0	0	0	0	0	0	0	0	0	0	0	0	459	460	0	0	0	0	0	0	0	0	0	0	0	0	0	0	554	0	0	0	0	0	0	0	0	0	0	0	0	0	178	178	178	178	178	178	178	178	178	178	178	178	178	178	178	178
0	0	0	0	554	0	0	0	0	0	0	0	0	0	0	0	0	0	434	435	0	0	0	0	0	0	0	0	0	0	0	0	0	0	0	0	0	0	0	0	0	0	0	0	0	0	0	0	178	178	178	178	178	178	178	178	178	178	236	178	178	178	178	178
0	0	0	0	0	0	0	0	0	0	0	0	0	0	0	0	0	0	459	460	0	0	0	0	0	0	0	0	0	0	0	0	0	0	0	0	0	0	0	0	0	0	0	0	0	0	0	151	178	178	178	178	178	178	178	178	178	178	178	178	178	178	178	178
0	0	0	0	0	0	0	0	0	0	0	0	0	0	0	0	0	0	434	480	482	0	0	0	0	0	0	0	0	0	0	0	0	0	0	0	0	0	0	0	0	0	0	0	0	0	0	176	152	178	178	178	178	178	178	178	178	178	212	213	178	178	178	178
0	0	0	0	0	0	0	0	0	0	0	0	0	0	0	0	0	0	459	580	533	0	0	0	0	0	0	0	0	0	0	0	0	0	0	0	0	0	0	0	0	0	0	0	0	0	0	176	178	178	178	178	178	178	178	178	178	178	237	238	178	178	178	178
0	0	0	0	0	0	0	0	0	0	0	0	482	0	0	0	0	0	434	435	582	0	0	0	0	0	0	0	0	0	0	0	0	0	0	0	0	0	0	0	0	0	0	0	0	0	0	176	178	178	178	178	178	178	178	178	178	178	178	178	178	178	178	178
0	0	0	0	0	0	480	482	0	0	0	0	533	0	0	0	0	0	459	460	0	0	0	0	0	0	0	0	0	0	0	0	0	0	0	0	0	0	0	0	0	0	0	0	0	0	0	201	202	178	178	178	178	178	178	178	236	178	178	178	178	178	178	178
0	0	0	0	0	0	580	533	0	0	0	0	582	0	0	0	0	0	434	435	0	0	0	0	0	0	0	0	0	0	0	0	0	0	0	0	0	0	0	0	0	0	0	0	0	0	0	176	178	178	178	178	178	178	178	178	178	178	178	178	178	178	178	178
0	0	0	0	0	0	0	582	0	0	0	0	0	0	0	0	0	0	459	460	0	0	0	0	0	0	0	0	0	0	0	0	0	0	0	0	0	0	0	0	0	0	0	0	0	0	0	176	178	178	178	178	178	178	178	178	178	178	178	178	178	178	178	178
0	0	0	0	0	0	0	0	0	0	0	0	0	0	0	0	0	0	434	435	0	0	0	0	0	0	0	0	0	0	0	0	0	0	0	0	0	0	0	0	0	0	0	0	0	0	0	176	178	178	178	178	178	178	178	178	178	178	178	178	178	178	178	178
0	0	0	0	0	0	0	0	0	0	0	0	0	0	0	0	0	0	459	460	0	0	0	0	0	0	0	0	0	0	0	0	0	0	0	0	0	0	0	0	0	0	0	0	0	0	0	0	0	0	0	0	0	0	0	0	0	0	0	0	0	0	0	0
0	0	0	0	504	0	0	0	0	0	0	0	0	0	0	0	0	0	434	435	0	0	0	0	0	0	0	0	0	0	0	0	0	0	0	0	0	0	0	0	0	0	0	0	0	0	0	0	0	0	0	0	0	0	0	0	0	0	0	0	0	0	0	0
0	0	0	0	529	0	0	0	0	0	0	0	0	0	0	0	0	504	482	460	0	0	0	0	0	0	0	0	0	0	0	0	0	0	504	0	0	0	0	0	0	0	0	0	0	0	0	0	0	0	0	0	0	0	0	0	0	0	0	0	0	0	0	0
0	0	0	0	554	0	0	0	0	0	0	0	0	0	0	0	0	529	582	435	0	0	0	0	0	0	0	0	0	0	0	0	0	0	529	0	0	0	0	0	0	0	0	0	0	0	0	0	0	0	0	0	0	0	0	0	0	0	0	0	0	0	0	0
0	0	0	0	0	0	0	0	0	504	0	0	0	0	0	0	0	554	459	460	0	0	0	0	0	0	0	0	0	0	0	0	0	0	554	0	482	0	0	0	0	0	0	0	0	0	0	0	0	0	0	0	0	0	0	0	0	0	0	0	0	0	0	0
0	0	0	0	0	0	0	0	0	529	0	0	0	0	0	0	0	0	434	435	0	0	0	0	0	0	0	0	0	0	0	0	0	0	0	0	533	0	0	0	0	0	0	0	0	0	0	0	0	0	0	0	0	0	0	0	0	0	0	0	0	0	0	0
0	0	0	0	0	0	0	0	0	554	0	0	0	0	0	0	0	0	459	460	0	0	0	0	0	0	0	0	0	0	0	0	0	0	0	0	582	0	0	0	0	0	0	0	0	0	0	0	0	0	0	0	0	0	0	0	0	0	0	0	0	0	0	0
0	0	0	0	0	0	0	0	0	0	0	0	0	0	0	0	0	0	434	435	0	0	0	0	0	0	0	0	0	0	0	0	0	0	0	0	0	0	0	0	0	0	0	0	0	0	0	0	0	0	0	0	0	0	0	0	0	0	0	0	0	0	0	0
0	0	0	0	0	0	0	0	0	0	0	0	0	0	0	0	0	0	459	460	0	0	0	0	0	0	0	0	0	0	0	0	0	0	0	0	0	0	0	0	0	0	0	0	0	0	0	0	0	0	0	0	0	0	0	0	0	0	0	0	0	0	0	0
0	0	0	0	0	0	0	0	0	0	0	0	0	0	0	0	0	0	0	0	0	0	0	0	0	0	0	0	0	0	0	0	0	0	0	0	0	0	0	0	0	0	0	0	0	0	0	0	0	0	0	0	0	0	0	0	0	0	0	0	0	0	0	0
0	0	0	0	0	0	0	0	0	0	0	0	0	0	0	0	0	0	0	0	0	0	0	0	0	0	0	0	0	0	0	0	0	0	0	0	0	0	0	0	0	0	0	0	0	0	0	0	0	0	0	0	0	0	0	0	0	0	0	0	0	0	0	0
0	0	0	0	0	0	0	0	0	0	0	0	0	0	0	0	0	0	0	0	0	0	0	0	0	0	0	0	0	0	0	0	0	0	0	0	0	0	0	0	0	0	0	0	0	0	0	0	0	0	0	0	0	0	0	0	0	0	0	0	0	0	0	0
0	0	0	0	0	0	0	0	0	0	0	0	0	0	0	0	0	0	0	0	0	0	0	0	0	0	0	0	0	0	0	0	0	0	0	0	0	0	0	0	0	0	0	0	0	0	0	0	0	0	0	0	0	0	0	0	0	0	0	0	0	0	0	0
0	0	0	0	0	0	0	0	0	0	0	0	0	0	0	0	0	0	0	0	0	0	0	0	0	0	0	0	0	0	0	0	0	0	0	0	0	0	0	0	0	0	0	0	0	0	0	0	0	0	0	0	0	0	0	0	0	0	0	0	0	0	0	0
0	0	0	0	0	0	0	0	0	0	0	0	0	0	0	0	0	0	0	0	0	0	0	0	0	0	0	0	0	0	0	0	0	0	0	0	0	0	0	0	0	0	0	0	0	0	0	0	0	0	0	0	0	0	0	0	0	0	0	0	0	0	0	0
0	0	0	0	0	0	0	0	0	0	0	0	0	0	0	0	0	0	0	0	0	0	0	0	0	0	0	0	0	0	0	0	0	0	0	0	0	0	0	0	0	0	0	0	0	0	0	0	0	0	0	0	0	0	0	0	0	0	0	0	0	0	0	0
59	60	59	60	59	60	59	60	59	60	59	60	59	60	59	60	59	60	59	60	59	60	59	60	59	60	59	60	59	60	59	60	59	60	59	60	59	60	59	60	59	60	59	60	59	60	59	60	59	60	59	60	59	60	59	60	59	60	59	60	59	60	59	60
TA	174	1132	Press Space to Jump
TA	512	1168	Press LShift to Sprint
TA	848	720	Press Q to Dash
SF	112	80	